N N N H H H N N N N B N B N N H N H H B N B H H N B N N B N H N B N H B N H N N B N B H B B B N N H 
B H N H N B H N N H H N H N H N N B H N N B N N H B B H N N N B H H H N N N N N H N H H B H N B N B 
N H H N H N N N H N N N B N N B N H H B N H N N B N N B N N N N H N N H B B N H N N H H N N H N N N 
N H B B N H N H N N H N H N N N B H H N B N N N H N N N N N N N N H N N H N B H H H H H N B N H H H 
N N B N B B N B N N N H B N B N H H H H N N N B B N N N N N N N H N N B N B B N B N N N N N N N B N 
H H N N H N H H N H N N N H B B H B N H B B H B N H N N N N N N H N B N N H H H H N N H B B H N N H 
N N N H B B N H N H N H N H N B B N H N N B N H H N H N N N H H N N N H B H N B H N H B H H N H N H 
N N N N H N N B H B N H N B N N H N N B H N H H B N B H B N H B N N B H H H N H N N N N H N N H N N 
N B N H N N N N N B H H H N N N N H N H N H N N H H H N B N N B N H N N N H N H N H B N B N H H N H 
N B B B H N H N N H B N N N B N N H H B H B N N H B B N N B H N H H N N N N N H N H H H N N B H N H 
N H N N N N N H H N N B H B B H N H B H N B H N H N N N H H N H B B H N N H N N B B N N H N B B N N 
N B H B B B H N N N N N B H N H N N N N B N H H H H N H N N B N H N B N H N B H B N N H B N H N H B 
N H B N N H N N H N H N N H N N B B N B N N H H H B N H N H N H H H N N B B H N H H N N B N N N H H 
N H B N N N H H N N H N H N N H N N N H N N H B N B H H B B N N N N N N B N N N N B H N B B N B H B 
N N H N N H H N H N N B B H H N H H B B H B H N B B B N N B N H N H B N N N H H B N N H N H B N B N 
H B N H N N N H B N H H N N B N B H H H N N N B H N N N H N N N B B N N N N B N N B H H N B B H N H 
H H H N N N N B B H H N H H H N H N H H H N H N N N B H N N N H H N N N B H N N N N N N N N N H B H 
N B N N H N H H N B H H N H N B N N N H N N N H N N H N N N N N H N N N H H N N H H N B H N B H B H 
N N N N N N B N N N N H B B N N N N B N B N B B H B N N H H N N B N H N N H N H H N H N N B H H B N 
H B H N N B H N N N N B N N N N B N N H B N H H B H N H B N B H H N N H B B H N N H N H N N H N H N 
B B N N B H H N H H N N H N N N N B N N N H H N H H N N B H B H N B N N B N N H B N N N H N H H H N 
H H H N N H N H B H N N B H H H H B N N H N N N B N B N H N N N H N N B N B H H N B N N B H H H H N 
B N H N N H H N H N B H N N N H N N H N H N N N N H B H H N B N H H N H N N B N H N H H N N H B B B 
N N H N N N N N H N N N N N N N N N N H N H N B N B H N N H H N B N H H N B N H N N B N H B N H N H 
N N H N H N N N N B B N H H H N B H N N H N H N N N H N N N H B N N N N H N H H H N N N B H N B H N 
H H N B H H H N H B B H H N N N H N H N H H N B N N H H N N H N H N H B N N B N N N N N N N N H H B 
N H H B H B H H N B B H N H N N B N N N N B B B N N N H H N N B N B N B N N N N N N N H H H H B N H 
N N B N N N H N N N H N H B N N N H N H H H H N H N N N H N H B B N H H B H H N H H B B B H H B N H 
H B N N N B N N N N B H H H N H N B N H B B N H N N H H N B N N N N H H N N B N B N B B N N N N N N 
N N B B N N N N H N N H N H B N N N H N N N N N N B N H B N H N B N H H N N B H B N B B H N H H H B 
B H H H H H N B N H H H N N H B H H N N N B N B H H B H B N N B N N N H N H B N H N H H B H N N B H 
N H N N N H N H N N H N H H H N H H N H H H B N H N B N N H N N B H H N B N H B N N H N N N N B H H 
B H N H N H H H B B B H N B H N N N N H B N N H B N B N N N N N N H H B B N H H N N N N B H B H N H 
N B H N N H H H N B B N N H H N N N N N N N N N N H H H N H N N N H H N N N N N H N N N B B B B N N 
B H H N N N H N H N N H N N N B H B N N H H H N B B B H H H N B N N N N N H H H H H N N H H B H H N 
N N H N N N N N N H N N H H N H B H B N N N N N H N H N N H N N B H N N H N N N N H H B N H N N N N 
H B H N N N H N N H H N H H N B B N N H H N N N N H N N N H N B N N N B H B B N N N B H N N N B B B 
B H N H B B N N H N B N N H N B N H N H N B N H N N H N N H N N H N H H B N N H B B B H H N N N N N 
H H N N B H B N H B N H B H N N H H N H N N N N B N B N B H N N N N N H H B B N B N H B H N N H N N 
H N N H H N N N N N N N N N N H H N N N H H H N B H N N H H N N N N N H H N N N N N H H B B H N H N 
H H N N B N N H H N N H N N H N N H B H H B H B B H B N N B N B N N H N N H H N N B N N N N N B N N 
H N N N H N N N N N N N N B H N N N N N N B B B N N N N N N N H N B H N N N N H N N B N B N B B N N 
H B N N B H H N H H H N B H N N B H N B H N H H N N N B H H H H B H N B N H N N N H H H N N H H N B 
N H N N N N B H N B B N B B H B N H N N N H B H N N B B N N B N B B B B B N N B H H H N H N N H N H 
B B N B N N H H N B H N H N N H B B H N H N B B B B N N N B N B N N N H B N H B N H H H H N B H N N 
N N B N N H N H H N H N N H H N N B N N N N N N B B N N N N N H N N N B N H N B N B H N B N N H N N 
N N H H N H N H N N H H N H B B B N B N H B B N N N N B B H N B B H N H H H N H N H H H N N N H B N 
N H N N H N H N N N B H B N N B N H H N H H N B H H N N N N H N N N H N N B N B N H H B N N B N B H 
N N N N N N H B B H N H H N N H H N N N N N H N N N N H N H N N N B B H N B B N N H B N B H H N B H 
N N B B H N N N H H H H B N H N B N H N N N H N N B H N N N H N B H B H H H N N N N N H N N B H H H 
N H N B N H N H H N H N B N H B B N H N H H H N B N N H H B H B N H N N N N N N H N H N N H N N N N 
N N N N H N B B N B B B B N B N N B H B H H H N N N N H B N N B N N H N B H N B N H N N H H H N H H 
H N H N H N H H N N N N B H H N H H H N H N N N B B N B B N H H N H B N H N B N B N N N N N N H H N 
N H N N N H N H N H H B B N N N B H B H N N H N B N B N N N H H H N H H H N B N N N H N H B N N N N 
B N N B B B N H B H N H H B B N N H N N N H N H H H N H N B N N H H N H N N N N H B N H H N N N N H 
N N N H H N B H N N B N B B N N H B N N N H H B N N H H H H B H N N N N N N H B N N N N B B N B N N 
H H N N N N B N N B N B H N N H N N N N N H N H B B B N N H N B N B B H N N H B N N N B N N H B N B 
N N N H N B N N H H N H N N B H N H H N B H N N N N B H H B N H N H B N N H N B B N H N H N H N N N 
N H H N N H B N H N N B N N B N N N N N N N H H N N H N N N H H B H N B N N N N N N N H N H N N H H 
N B N H N N N H N B H N N H N H B N N H B N H H B N H H N N N B N N H N B B N N B H H H H N N N N N 
H H N H H N B N H N N H N N B B H B N N B N N H B H H N N N H N B N H H H N H B N B H N B H N H B N 
N N N N H B H H H N B N H B N N H H N N H B N N N N H N H H N H N N N N B N N N N N B B H B H N H H 
B N H H H N N N N H N N N N N B H B N H B N N B N B N N N N H H N N H H H B N H N H N H N H H H N N 
N N N B N N B H N H N N N H N H H N N N N B B H H H N N N H B H N N N N N B H N H B H H N N N N H N 
H N N N B N N N H H B H B N N N N B N B N N B B N B H B N N H B N N N N B N N B N B N H H B N H N N 
H N B N B B N N N N N H B B B B B N N N N B N N H H N B H N N N N B N N N N N H B N N N H N H N N N 
N N B H B B N N B N B N H H B N N B N N N B H H H B B B H N N H N N N N N B N N N N N H H B B B B B 
H N N H N N N B B N H N B N N N N B H H N N H N H B N H B N N N H N H N H N N H N B H N B B N N N N 
H N N B H H B H H B H H H H B N H H N N H N B H B N H B N N H H N N N B B H H B N N N H H N N B B H 
H B H N N N N N N B N H N N N N B N N N N N N N H B H H B N B N N B N B N N H N N N H N N H B N B N 
H H N N N B N B H N B N N B H H N N B H H H H N H H H B N B N H B B N N H B B H H H N H N N H N N N 
N H N N B N B N H N N N N B N N H H N N N N N N B B N N N N H N B N N N N N N H B N H H B N H H B B 
N H N N N N N H N H H H H N N N H H H H H H H N N N H N N N H N N H N H B N H N H N N N B N N B N N 
N H B N N H N N H H N N H B H N N B B H N N N H N H H H B B B N B H N H N B N N H H B N N N N N N H 
H N N B B N B N N N H H B B H N N N N H N N B H N H H H B B N H H N H H H N B N N B N N N N N N H N 
B H B H H B N N N B N B B N N N H N N H N B N H N N H N B N H N B N N N N N N B H H N N N N N H H H 
B N H N H N H H H H B N N N B H N N N H H N H N B H B N H N B B H H B N N H N H N B N B N N H N H N 
H H H H N N N B H N B B B N H N N H H N N H B H N B N H B N N B H N N H N H H H H N N N B N N N H N 
B N N N B N N B H H B H H N N N H B H N H H H B N N N B N N N N N H N H H H B H H B N H N H N H N H 
H H B H N H N B N H N H H N N B N H B N N N N N H B B H H N N B N N B H H H N H H H H N N N N N N H 
N H H N N N H N H N H N H N N B B N B N H N N N N N N B H B N N N B N B N N N H N N B H H N N B H N 
N N N N N B B N H H H N B N N N N N N B H N N N H H N N N H H H N B N H H N N B N B B H N B N B N B 
N N H N N N H N H H N H H N H N N B N H B N H B N B N N H B N N B N N H N B H H H H H N N H N H B N 
H H H N N N H N H N B H N B B N N N N N B B N N H H H N N N B N H N N H N N H N H H B H B H H N N N 
H N B N B N N B H N H N N B H N N N N N N B N H N B H H N N N N N N B B B N B B N H H B N N N N N N 
B N B N N N H N H B B B B N H H N H N N H H B N N N N N N H B N H N N N H N H B N H H N B B N N N N 
N N N N B H N N N N N N N N N B N B N N N B B H H B N N N B B H N B H B B N B N N N N H N H H B N N 
N N N N N H N B N H H N B H B N N H H H N N H N N H N N N N N N N H N N N N H N B N B N N B N N B N 
N N H N H B B N N H N N H H N H N N N H H N N H B N B N B N N N B N N H N N N N B N N H B N B H H B 
N N N H B H H N N N B H B N H N B N N N B B N N H H H N H N B H N H B B H H N B N N H B B N N H N N 
H B H N B H N H N N N N N H N B N N B N H N N H N N B H N N B B H H N N N N H H N H N N N H B H H N 
N H H N H N B N H H H H H N B N B H N H H H H B N N H N B N N B H H N B B H H H N N N H H N B H N H 
N N N H H B N N H H N N H N N H B N H B N H B N N N B B N N B N N B H N N N B N H N B H H H H N N H 
B N H H N N B N N H N N N B H B B N H H B H N N N N N N B N B N H N N H H H N B N H N H N H N N N B 
H H N B N N N H B B N B B B N N N H H N N N B H B B H N N B H B H H B N H B B N H N N B B N B B H N 
B H N N H B B N N H N B H H N N H N B B B N B N N H N N B H H N H B N N N N H N H B N H N H B N B H 
H N B N B N B B H N H N N B N H H N N H B B H H B N H B H N N H N N N N N H N B B N H N N N N H H H 
N N N N N N H N N N H B H N N N N N N N N N H H N N B B B H H N H H N H N H N B N H H N N H N B N N 
H H H H B B N B N H B H H B H H N H N H N N H N B H B H H H N N N H N H B N N N H N N N B H B H H H 
B H H N H N N N N H H N B N N H N B N B B N B B N N H N N H H N H N H H N N N N H B H N N N H B N N 
