H N B H N N B N N 
N N B N N N N N B 
N H H N H N N B H 
N H N B B H N B N 
H B N H B H B B H 
N B H H N N N N N 
H N N N H H H N B 
B B N N H B N H H 
H H N N H N N H H 
